0400000000000000000000000000000000000000000000000000000000000
0101111111110101111101110101010111010111110101111111111111110
0101000000010101000100010101010001010001010101000001010000000
0101010111010111110111011111110111111111011111111101011111110
0100010001010100000000010000000100000100000001010001000101000
0111111101010111111111011111111111110111011101011101010101010
0000000101010100000000010000000001000000010001000001010000010
0111111101111111111111111111011111111111111101111101111111010
0000010000000100000101000001000000000101000000010000000000010
0101110101111111110101011101111111110101110111011101110111110
0100010100010000010000010000000001010000010001010001000001010
0111010101111111011111111111011101011111010101010111111111010
0001010101000000000001000100010000000000000101000100000001000
0111111111011111111101110111110101011111011101110111010101110
0001000001010000000001010000000101010000000101000100010100000
0111110111111111011111011101011111011111111111110111010111010
0100000001000000000001000001010000010000010001000100010100010
0101110101111101111101111111111111111111011101010111010111110
0000010101000000010000000000000100000001000000010100010100000
0101111111111111111111111111010111111101111111111111111111110
0100010001010001000000010100010100000001000100000100000001010
0111111101010101111111010101111111110111011111011111111101010
0001000001000100010001000101010101010000010100010101000001010
0111011111111111010111110101010101011111010111010101010101010
0001000101000100000000010100000100000000000100000101010100000
0111110101011111111111010111110111111111011101110101111111010
0001010101010100000001010100000101000001000001010101000100010
0111010101010111111101010111011101111101111111010101011111110
0000000000000000000000000000000000000000000000000000000000000
0000000000000000000000000000000000000000000000000000000000000
