0040000000000000000000000000000000000000000000000000000000000
0011101111111111101010101110101011101111111110111111101010100
0000100000000010101010101000101000101010100000001000001010100
0011111011111010111111111010111110101010111111111110111011100
0000001000100000000000100010001000100000101000000000101010000
0010111010111111111011101111101111101111101011101011101010100
0010001010100000000000100000101000000000100000101010000010100
0011111010111111101110101110101110111010111110111111101011100
0000001010101010001000100010101000100010001000100000101010100
0011101111101011101111101010111010101011111110111110111010100
0010001010000010000000101010100010101000100000101010000010000
0010111010111010111011101111101111101111101111101011111110100
0010000010100000001000100000100010100000101000000010101000100
0011111111101110111111111010111010111110111110111010101011100
0010100010000010000000001010100000001000100000100000000010000
0010101011101110111011111011101110111110111111111110101111100
0010001000100010001000001000101000001000101010001000101000000
0010111111101110101010111010101010111011101010101111111011100
0000000000101000101010001010101010001010000000100000100010000
0011101111111110101010101110101111111111111111111110111111100
0000100010001000101010100010100000100000001000001000101000000
0011111111101110101011111111111111111111101111101110101111100
0000001000000010101010001000000010000010000000101000001000000
0010101010101111111111101011111110111011111110101110111111100
0010100010101000000010001010100000101010001000000000001010100
0011111111111110101110101010111111101011101111111110111010100
0000100000001010100000100000101010101010001000000010000010100
0011101111111010111111111111101010101011101111111011101110100
0000000000000000000000000000000000000000000000000000000000000
0000000000000000000000000000000000000000000000000000000000000
