0000000000000000000000000000000000000000000000000000000000000
0000000000000000000000000000000000000000000000000000000000000
0010101010111010101110101111101110111110101011101111111011100
0010101010100010101000100000101000100000101010001000000010000
0011101011101110111110101011111111111011101110101110101111100
0000101010000010100010101000101000000000100010100010101000000
0010111011101110101111101111101010101111101111111011111110100
0010001010000010000000101000001010100000100010100000100000100
0011111011111010101010101010111111111010101110101110101111100
0010001010101010101010100010001000000010100010000010101000000
0010111110101111111111101110111010111010111010101110111110100
0010100000001000000000101000001010001010100010100010100010100
0010101011111110111111111110101111101111111110101111111011100
0000101000001000000000100000100010000010100000100010101010100
0010101111111011101111111111101110111010111010111110101010100
0010001000001000100010100000001010001000100010100010001010000
0010111011101010111110101111101010101011111111111010111011100
0010000000100010001000100010000010101010001000000000101000000
0010101111111110111011111110101010101110111010111011101111100
0010100010101010000000000010101010100010000010101000000010000
0011111110101011111110111111101010101111111111101011101111100
0010101010001010000010000010001010101000001010000000100010100
0010101010111010101111101111111110111111101011111111101110100
0010100000100000100000100000100000001010100010101010101010000
0010101111111011111111111111111010111010101010101010101011100
0000100010100000100000001010101010001000101000100000000000100
0011101010101111101111111010101111101110111110111111101110100
0000101000000000001010001000001000101010001000100010101000100
0011101111111111111010111011111011111011101110111010111110100
0040000000000000000000000000000000000000000000000000000000000
